		      #################################
		      #################################
                      #################################
		      #################################
                      #################################
		      #################################
                      #################################
                      #################################
                      #################################
		      #################################
                      #################################
#############################################################################
#############################################################################
#############################################################################
#############################################################################
#############################################################################
#############################################################################
######################################S######################################
#############################################################################
#############################################################################
#############################################################################
#############################################################################
#############################################################################
#############################################################################
#############################################################################
		      #################################
                      #################################
		      #################################
                      #################################
		      #################################
                      #################################
		      #################################
                      #################################
                      #################################
                      #################################
		      #################################