#######################################################################################
#######################################################################################
#######################################################################################
#######################################################################################
#######################################################################################
#S#   #   #   #   #   #   #   #   #   #   #   #   #   #   #   #   #   #   #   #   #   #
#   #   #   #   #   #   #   #   #   #   #   #   #   #   #   #   #   #   #   #   #   # #
# #   #   #   #   #   #   #   #   #   #   #   #   #   #   #   #   #   #   #   #   #   #
#   #   #   #   #   #   #   #   #   #   #   #   #   #   #   #   #   #   #   #   #   # #
# #   #   #   #   #   #   #   #   #   #   #   #   #   #   #   #   #   #   #   #   #   #
#   #   #   #   #   #   #   #   #   #   #   #   #   #   #   #   #   #   #   #   #   # #
# #   #   #   #   #   #   #   #   #   #   #   #   #   #   #   #   #   #   #   #   #   #
#   #   #   #   #   #   #   #   #   #   #   #   #   #   #   #   #   #   #   #   #   # #
# #   #   #   #   #   #   #   #   #   #   #   #   #   #   #   #   #   #   #   #   #   #
#   #   #   #   #   #   #   #   #   #   #   #   #   #   #   #   #   #   #   #   #   # #
# #   #   #   #   #   #   #   #   #   #   #   #   #   #   #   #   #   #   #   #   #   #
#   #   #   #   #   #   #   #   #   #   #   #   #   #   #   #   #   #   #   #   #   # #
# #   #   #   #   #   #   #   #   #   #   #   #   #   #   #   #   #   #   #   #   #   #
#   #   #   #   #   #   #   #   #   #   #   #   #   #   #   #   #   #   #   #   #   # #
# #   #   #   #   #   #   #   #   #   #   #   #   #   #   #   #   #   #   #   #   #   #
#   #   #   #   #   #   #   #   #   #   #   #   #   #   #   #   #   #   #   #   #   # #
# #   #   #   #   #   #   #   #   #   #   #   #   #   #   #   #   #   #   #   #   #   #
#   #   #   #   #   #   #   #   #   #   #   #   #   #   #   #   #   #   #   #   #   # #
# #   #   #   #   #   #   #   #   #   #   #   #   #   #   #   #   #   #   #   #   #  E#
#######################################################################################
#######################################################################################
#######################################################################################
#######################################################################################
#######################################################################################