#################################
#S                              #
############################### #
#                             # #
# ########################### # #
# #                         # # #
# # ####################### # # #
# # #                    E# # # #
# # # ##################### # # #
# # #                       # # #
# # ######################### # #
# #                           # #
# ############################# #
#                               #
#################################